|   |   |     |       | | |
- - - ----- - - - --- - - -
| | | | |   | |     |     |
- - - - --- - --- --  - ---
|     |   |     |   | |   |
- - - - - - - - - - - - - -
|   |   |     |     |     |
- - - ----- - --- --  - ---
| |   |   |     |   | |   |
- - - --- - - - - - - - - -
|s  |   |     |     |    t|
---------------------------

