|s  |   |     |       | | |
- - - ----- - - - --- - - -
| | | | |   | |     |     |
- - - - --- - --- --  - ---
|     |   |     |   | |   |
- - - - - - - - - - - - - -
|   |   |     |     |    t|
---------------------------

